########################################################
#                                                      #
#       #                       ##################     #
#       ##################      #               ##     #
#   #                    #      #   ####################
#   #               #      #    #                      #
#   ##################       #  #                      #
#      ##################      #     # #################
#                               #####                  #
#       ##################                             #
#   #          #          #         ####################
#  #       #       #       #                           #
#  ##################      #            ################
#                                                      #
#                     ##################               #
########################################################